# 3 1	# 3 1	# 3 2	# 3 3	# 3 1
# 3 1	. 3 0	. 3 0	. 3 0	# 3 1
# 3 1	. 3 0	. 3 0	. 3 0	# 3 1
# 3 1	. 3 0	. 3 0	. 3 0	# 3 1
# 3 1	. 3 0	. 3 0	. 3 0	# 3 1
# 3 1	# 3 1	# 3 1	# 3 1	# 3 1