# 3 1	# 3 1	# 3 1	# 3 1	# 3 1	# 3 1	# 3 1	# 3 1	# 3 1	# 3 1	# 3 1	# 3 1	# 3 1	# 3 1	# 3 1	# 3 1	# 3 1
# 3 1	. 3 1	. 3 1	. 3 1	. 3 1	. 3 1	. 3 1	. 3 1	. 3 1	. 3 1	. 3 1	# 3 1	# 3 1	. 3 1	. 3 1	# 3 1	# 3 1
# 3 1	. 3 1	G 3 1	G 3 1	G 3 1	G 3 1	G 3 1	# 3 1	# 3 1	# 3 1	. 3 1	. 3 1	# 3 1	. 3 1	. 3 1	# 3 1	# 3 1
# 3 1	. 3 1	. 3 1	. 3 1	. 3 1	. 3 1	# 3 1	# 3 1	# 3 1	# 3 1	# 3 1	. 3 1	. 3 1	. 3 1	. 3 1	. 3 1	# 3 1
# 3 1	. 3 1	. 3 1	G 3 1	. 3 1	. 3 1	. 3 1	. 3 1	. 3 1	. 3 1	. 3 1	. 3 1	. 3 1	. 3 1	# 3 1	# 3 1	# 3 1
# 3 1	. 3 1	. 3 1	. 3 1	G 3 1	. 3 1	# 3 1	# 3 1	# 3 1	# 3 1	# 3 1	# 3 1	. 3 1	# 3 1	# 3 1	# 3 1	# 3 1
# 3 1	. 3 1	. 3 1	. 3 1	. 3 1	. 3 1	# 3 1	# 3 1	# 3 1	# 3 1	. 3 1	. 3 1	. 3 1	# 3 1	# 3 1	# 3 1	# 3 1
# 3 1	. 3 1	. 3 1	. 3 1	. 3 1	. 3 1	. 3 1	# 3 1	G 3 1	# 3 1	. 3 1	. 3 1	# 3 1	# 3 1	# 3 1	# 3 1	# 3 1
# 3 1	# 3 1	# 3 1	# 3 1	# 3 1	# 3 1	. 3 1	. 3 1	. 3 1	. 3 1	. 3 1	. 3 1	# 3 1	# 3 1	# 3 1	# 3 1	# 3 1
# 3 1	# 3 1	# 3 1	. 3 1	. 3 1	# 3 1	. 3 1	# 3 1	# 3 1	# 3 1	# 3 1	# 3 1	# 3 1	# 3 1	# 3 1	# 3 1	# 3 1
# 3 1	# 3 1	# 3 1	. 3 1	# 3 1	# 3 1	. 3 1	# 3 1	# 3 1	# 3 1	# 3 1	# 3 1	# 3 1	# 3 1	# 3 1	# 3 1	# 3 1
# 3 1	# 3 1	# 3 1	. 3 1	. 3 1	. 3 1	. 3 1	. 3 1	. 3 1	# 3 1	# 3 1	# 3 1	# 3 1	# 3 1	# 3 1	# 3 1	# 3 1
# 3 1	. 3 1	. 3 1	. 3 1	# 3 1	# 3 1	. 3 1	. 3 1	. 3 1	. 3 1	. 3 1	. 3 1	. 3 1	. 3 1	# 3 1	# 3 1	# 3 1
# 3 1	. 3 1	# 3 1	# 3 1	# 3 1	# 3 1	# 3 1	. 3 1	. 3 1	. 3 1	. 3 1	. 3 1	. 3 1	. 3 1	# 3 1	# 3 1	# 3 1
# 3 1	# 3 1	# 3 1	# 3 1	# 3 1	# 3 1	# 3 1	# 3 1	# 3 1	# 3 1	# 3 1	# 3 1	# 3 1	# 3 1	# 3 1	# 3 1	# 3 1